###################
## STARTING TAGS ##
###################

# NORTH AMERICA
QIQ = "countries/Qingqiu.txt"
ATH = "countries/Athapaska.txt"
SIX = "countries/Sioux.txt"
UTH = "countries/Deseret.txt"
NAV = "countries/Navajo.txt"
LOU = "countries/Louisiana.txt"
VIN = "countries/Vinland.txt"
VIR = "countries/Virginia.txt"

# MIDDLE AMERICA
GCO = "countries/Gran Colombia.txt"
AZT = "countries/Aztlan.txt"
MEX = "countries/Mexica.txt"
MAY = "countries/Maya.txt"

# SOUTH AMERICA
JAM = "countries/Jamaica.txt"
INC = "countries/Tawantinsuyu.txt"
BEO = "countries/Beornia.txt"
BRA = "countries/Brazil.txt"
AMZ = "countries/Amazonie.txt"

# EUROPE
SCD = "countries/Scandinavia.txt"
CNU = "countries/Ireland.txt"
SCO = "countries/Scotland.txt"
ENG = "countries/England.txt"
FRA = "countries/France.txt"
SPA = "countries/Spain.txt"
ARA = "countries/Aragon.txt"
NVR = "countries/Basque.txt"
BUR = "countries/Burgundy.txt"
TYK = "countries/Pomerania.txt"
HAN = "countries/Hannover.txt"
BAY = "countries/Bavaria.txt"
BOH = "countries/Bohemia.txt"
SWI = "countries/Switzerland.txt"
AUS = "countries/Austria.txt"
GTC = "countries/Genoa.txt"
VEN = "countries/Venice.txt"
ITA = "countries/Italy.txt"
PLC = "countries/Commonwealth.txt"
UKR = "countries/Ukraine.txt"
BEL = "countries/Belarus.txt"
HUN = "countries/Hungary.txt"
CRO = "countries/Croatia.txt"
EST = "countries/Estonia.txt"
RUS = "countries/Russia.txt"

# MIDDLE EAST
OTT = "countries/Ottoman Empire.txt"
GRE = "countries/Greece.txt"
WAL = "countries/Wallachia.txt"
MOL = "countries/Moldova.txt"
TRA = "countries/Transylvania.txt"
RIY = "countries/Riyadh.txt"
YEM = "countries/Yemen.txt"
ARB = "countries/Arabia.txt"
PER = "countries/Persia.txt"
TRN = "countries/Turan.txt"

# INDIA
DUR = "countries/Durrani.txt"
KAS = "countries/Kashmir.txt"
IRP = "countries/Indian National Congress.txt"
SND = "countries/Sindh.txt"
UTK = "countries/Utkala.txt"
VND = "countries/Vindhya.txt"
DEC = "countries/Deccan Federation.txt"
DRA = "countries/Dravidia.txt"
ARY = "countries/Aryan State.txt"
BEN = "countries/Bengal.txt"
SPI = "countries/Spanish India.txt"
SIN = "countries/Scandinavian India.txt"
NEP = "countries/Nepal.txt"
BHU = "countries/Bhutan.txt"
CHL = "countries/Chola.txt"
BRM = "countries/Burma.txt"

# EAST ASIA
TIB = "countries/Tibet.txt"
QIN = "countries/Great Qing.txt"
MON = "countries/Mongolia.txt"
UYG = "countries/Uyghuristan.txt"
JAP = "countries/Japan.txt"
# MAN = "countries/Manchuria.txt"
JRS = "countries/Shiberiya.txt"
# SIA = "countries/Siam.txt"
MLC = "countries/Malacca.txt"
JPH = "countries/Philippines.txt"
BEI = "countries/Burgundian Indies.txt"
SEI = "countries/Spanish Indies.txt"
JEI = "countries/Japanese Indies.txt"
